Commit Id	Time	Total LOC	LOC added	LOC removed	Files affected	Files added	Files removed	Commit Msg
f3b0cefd0b1	2	15	6	9	1	0	0	17
a650138ebf9	16	4	1	3	1	0	0	5
9c6263bff8b	1	22	15	7	1	0	0	8
45948e054d1	14	228	209	19	4	1	0	12
e15221a8dee	17	6	5	1	1	0	0	37
a8e1e8d057a	17	12	11	1	1	0	0	2
e8795cea304	17	10	10	0	1	0	0	2
893ebe72305	17	19	15	4	2	0	0	5
b8eee9c6f00	17	19	15	4	2	0	0	5
fe838611f6d	0	61	53	8	2	0	0	8
42a369620ff	17	36	30	6	2	1	0	5
528c28587f1	23	74	50	24	2	0	0	7
501b4a54be5	0	2	1	1	1	0	0	25
f3b0cefd0b1	2	15	6	9	1	0	0	17
a650138ebf9	16	4	1	3	1	0	0	5
9c6263bff8b	1	22	15	7	1	0	0	8
45948e054d1	14	228	209	19	4	1	0	12
e15221a8dee	17	6	5	1	1	0	0	37
a8e1e8d057a	17	12	11	1	1	0	0	2
e8795cea304	17	10	10	0	1	0	0	2
893ebe72305	17	19	15	4	2	0	0	5
b8eee9c6f00	17	19	15	4	2	0	0	5
fe838611f6d	0	61	53	8	2	0	0	8
42a369620ff	17	36	30	6	2	1	0	5
528c28587f1	23	74	50	24	2	0	0	7
