Commit ID 	 Time 	 LOCChanged 	 LOCADD 	 LOCRem 	 Totalfiles 	 Filesadd 	 Filesrem 
8e57398b203	00	14	11	3	1	0	0
d75de86e6d8	02	6	6	0	0	0	0
90fb81ad540	01	600	361	239	102	8	1
dd8018de956	19	4	2	2	1	0	0
9a059ea69e1	00	56	44	12	4	0	0
56f65e3c3e1	16	497	399	98	109	19	0
2255efa171e	00	232	122	110	95	0	0
bb9316da28f	02	1767	1049	718	158	21	7
f490934c33b	19	22	17	5	1	0	0
93188918ea7	22	334	177	157	6	0	0
580e67015c4	01	37	37	0	2	1	0
cf20b6bf65b	23	85	78	7	7	1	0
db273818f6c	02	16	8	8	3	0	0
ffc81106598	19	21	20	1	1	0	0
1ad30a2af49	23	196	99	97	95	0	0
0f6d3e22d9e	20	1	0	1	0	0	1
d5f401147ac	18	1	1	0	0	1	0
61764613d1b	00	1706	731	975	252	0	27
e85a95dfa34	17	23754	23739	15	218	217	1
3ab15cde251	00	8492	1667	6825	132	15	104
0ba78d5f362	21	89	86	3	2	0	0
e543b0e95e7	22	11	10	1	1	0	0
975f1930b1c	22	11	10	1	1	0	0
06190928c0c	23	10	5	5	1	0	0
4c5751ba977	19	148	146	2	2	1	0
2d02e6a9920	17	34	25	9	3	0	0
caf70f5e941	15	145	104	41	3	0	0
b70fed48a7f	01	143	40	103	3	0	0
e6f147141e4	16	86	83	3	1	0	0
59a5262041d	23	53	53	0	3	2	0
4f91b72dbe4	18	3	2	1	1	0	0
ff942c6b39d	18	3	2	1	1	0	0
c828ded0c2b	18	2	1	1	1	0	0
74c02066fe0	02	64	64	0	1	1	0
e06ce7562ca	17	23	16	7	4	0	0
b3af074a025	16	7	4	3	1	0	0
98990b97798	16	23	20	3	3	0	0
dc8f4eed53b	17	54	54	0	1	0	0
190abcac9de	00	23	15	8	1	0	0
8b6277a4602	00	6	5	1	4	0	0
ef523e5719f	05	6	3	3	1	0	0
ef27d56cc12	15	29	0	29	1	0	0
6b6f2b1d2ca	15	29	0	29	1	0	0
b4712bf1ac2	20	10	8	2	1	0	0
711a356468d	20	10	8	2	1	0	0
f90264d2462	06	50	35	15	1	0	0
d104bfd5a6d	06	32	19	13	3	0	0
5b8e1dabbc1	23	17622	17615	7	44	45	0
ac4791393ed	22	9	7	2	2	0	0
3210809d0ac	22	9	7	2	2	0	0
ef35f4d6c1b	00	64	64	0	1	1	0
703a1ffe52b	18	120	4	116	10	0	5
c050d0fa19a	01	11	5	6	3	0	0
bf0802402d5	00	5	3	2	1	0	0
588d885e81d	00	14	14	0	2	0	0
ddfc6b78cc1	18	13	11	2	2	0	0
dcecfc5f1b4	16	15	12	3	2	0	0
448eab2587d	22	6	4	2	2	0	0
7f0047c2d52	21	224	43	181	8	0	4
ebc4d5cd290	22	17	0	17	1	0	0
9b5098f509a	20	34	33	1	7	4	0
fc80ee947a6	00	45	45	0	1	0	0
87900b14da5	20	18	7	11	1	0	0
8475e1527dd	20	3	2	1	1	0	0
9967c369c92	17	121	117	4	10	5	0
794cb60f9e8	17	2	1	1	1	0	0
580ab7ba2c1	17	4	2	2	1	0	0
249361cab79	11	36	23	13	1	0	0
307f39ce9ed	20	71	64	7	2	0	0
7c6f0147dfa	18	70	44	26	1	0	0
a7ce79124e6	03	24	23	1	3	0	0
bbffd9e5025	16	4	2	2	1	0	0
8df6f9e5446	19	128	125	3	7	6	0
8fd1c68f062	02	100	100	0	1	1	0
0b3ecc05a68	19	37	27	10	2	0	0
efca5f8e78a	00	45	45	0	1	0	0
3935adced09	23	42	42	0	2	0	0
5cfac218526	22	107	101	6	3	0	0
90802d628df	22	190	171	19	2	0	0
7ee8c5676b5	19	18	13	5	1	0	0
6d85da185c8	22	169	164	5	3	1	0
e1a72f0e2e4	21	12	10	2	2	0	0
4d64f363385	21	9	5	4	2	0	0
7bff70268a4	18	4	2	2	1	0	0
3c9fb3ec1af	18	11	10	1	2	0	0
11a06fe1e4c	05	6	4	2	2	0	0
bc8e9b340dd	20	58	30	28	1	0	0
d664bf376d1	18	222	150	72	2	0	0
3599c71dae1	22	11	9	2	2	0	0
a48f73d0d34	23	2	2	0	1	0	0
f3d364122dc	05	6	4	2	2	0	0
2cfe7b847d9	05	1	1	0	1	0	0
0aa1a8a005c	01	85	84	1	6	0	0
8b9dbdad272	01	8	8	0	2	0	0
f8defa3e090	20	9	8	1	4	2	0
f07041e6cd2	23	3	3	0	1	0	0
ff39d413a3c	21	315	261	54	1	0	0
81b4d453547	21	10	6	4	2	0	0
46513483cd9	21	92	89	3	9	6	0
9bed5dcb2c5	00	133	109	24	3	0	0
2e6a263e292	08	20	18	2	2	0	0
5f2e90934e5	18	71	52	19	4	0	0
da2f4b2dc42	01	53	53	0	5	2	0
2f1f22ab26e	01	59	34	25	1	0	0
f86ec1366f7	17	23	20	3	3	1	0
6cdeb3b3fd1	21	22	17	5	4	2	0
430a7f1bed7	00	33	28	5	2	0	0
49275524a5d	18	9	7	2	1	0	0
d40af91b301	00	964	482	482	2	0	0
435ece50589	02	151	126	25	3	0	0
6f5d95de6df	02	87	81	6	4	1	0
48334dc0b1b	19	11	8	3	1	0	0
3d0627dc6aa	19	3	2	1	1	0	0
47c40bf18d3	19	50	30	20	1	0	0
dc2b4b2a819	19	266	140	126	1	0	0
6525c045229	18	264	148	116	1	0	0
7c57eb2aec1	19	251	141	110	1	0	0
a52f59b437d	02	220	111	109	3	1	1
a2b3c865c92	19	4	2	2	1	0	0
b52b4196ab2	19	34	29	5	2	0	0
c73041b3d59	04	52	43	9	2	1	0
3c9746de244	19	47	40	7	2	0	0
d39d3cec65a	08	8	8	0	1	0	0
9996b459e15	21	231	186	45	4	0	0
589e27948ba	04	52	43	9	2	1	0
987cbbc191c	19	47	40	7	2	0	0
4c514a723cf	23	4	2	2	1	0	0
446d2ec19c9	18	23	17	6	1	0	0
5e14c8bec0b	20	13	7	6	2	0	0
b0adaff67e4	00	32	27	5	2	0	0
bfc6b51d955	19	11	1	10	1	0	0
492fc0d7524	18	19	12	7	1	0	0
b0aadbea6b7	20	21	16	5	1	0	0
226eff51045	01	66	47	19	3	1	0
25b5bc01a6f	23	135	135	0	1	1	0
8ff79541652	19	9	7	2	2	0	0
e9b6b0b327e	06	16	12	4	4	0	0
4d0456f827c	00	123	72	51	2	1	0
dff1b5ad109	23	4	4	0	3	1	0
bb08f0c219b	23	216	28	188	3	0	0
66bce65d33b	16	58	55	3	2	0	0
686d9f9cc66	16	58	55	3	2	0	0
c099e274d2e	01	42	31	11	5	0	0
85fb47c11cc	01	42	31	11	5	0	0
2f071ac7d18	00	239	119	120	2	0	0
b2dfea03618	00	23	16	7	2	0	0
3f7c791b135	03	6	5	1	1	0	0
53dac7c341a	20	2	1	1	1	0	0
ba0c32e2e1a	00	239	119	120	2	0	0
0e311717b5b	00	23	16	7	2	0	0
072750e6629	03	6	5	1	1	0	0
e55c4868013	20	2	1	1	1	0	0
1a1214866ff	01	2	1	1	1	0	0
e9aacd40c68	22	20	14	6	1	0	0
65037eeb320	00	6	6	0	2	0	0
f0f247d7e5b	07	11	5	6	3	0	0
d75b63bc3c5	00	8	7	1	2	1	0
49e0f14a2f9	17	95	54	41	6	4	0
781d51285d6	04	2	1	1	1	0	0
73f207fe598	07	27	18	9	1	0	0
4ce100fa622	04	119	95	24	3	0	0
1ffdad010bd	06	2	2	0	1	0	0
e65e6039a83	20	3	3	0	1	0	0
94be898fbc6	21	6	0	6	2	0	1
a26f7d753dc	00	9	8	1	1	0	0
82813f2f8cf	00	39	25	14	1	0	0
3c7873bd3f7	23	37	30	7	1	0	0
5b740c488f0	06	4	2	2	1	0	0
78be1e49300	23	48	0	48	1	0	0
bc45adcffac	19	7	6	1	1	0	0
c0d42b03653	04	2	1	1	1	0	0
3892628657c	01	7	7	0	1	0	0
cfd459abde7	01	952	478	474	3	1	0
e0061a511d6	01	138	72	66	3	1	0
7ff53f4c6aa	01	150	76	74	3	0	0
57fbb627cad	20	130	65	65	8	0	0
de9778b5bdc	15	2	1	1	1	0	0
4befe93a4b4	22	108	79	29	2	0	0
6e603ccbe2d	00	2	1	1	1	0	0
31ed37fdf0a	01	31	14	17	2	0	0
943b2c61a80	06	41	31	10	2	0	0
976983960d6	08	52	43	9	3	0	0
b90d63b9983	23	2	1	1	1	0	0
602d1861a1c	23	3	2	1	0	0	0
c488e5775a5	23	9	6	3	3	0	0
a38aa02f9f3	23	6	4	2	1	0	0
5861db8a696	23	163	81	82	77	0	0
0dba38eef0f	09	2	1	1	1	0	0
9acc8a686a4	04	49	45	4	4	0	0
46a47d27991	05	25	21	4	1	0	0
3adcdfc2e1d	22	1693	1350	343	4	0	0
f118b718194	01	151421	66024	85397	2237	588	1415
f7ede33f091	21	34	31	3	2	0	0
120f7cf55fb	01	7005	2925	4080	115	1	0
dbec0a0cd8a	23	288	171	117	113	1	0
f76c3938d06	18	1365	879	486	256	15	0
75bc11cf12f	22	1473	1137	336	246	9	0
9520adeb37f	21	32	32	0	2	0	0
bd547d65983	16	9678	5601	4077	312	33	3
a65c1aaf3af	16	9678	5601	4077	312	33	3
217bb0c9641	04	2165	1556	609	174	20	0
ec2fc4ca4d3	04	2165	1556	609	174	20	0
89caae26ba6	18	435	306	129	124	6	0
55543d3c457	02	3398	1260	2138	172	15	17
2e8bb57fe37	04	488	238	250	212	0	0
485fcf9c636	21	446	111	335	115	0	7
f645c40fcd9	05	6912	1195	5717	181	13	24
e7f7e2aeca7	17	54	54	0	1	1	0
1be93659303	01	1144	665	479	217	8	2
7f82faee307	03	445	277	168	124	1	0
2a741f2d121	22	234	119	115	111	0	0
e10c223eb6b	17	234	118	116	110	0	0
97738994e0b	00	1995	1244	751	172	16	0
a22de4f7eed	18	17822	13644	4178	410	74	66
b371d4ae8fd	09	17	17	0	1	1	0
90655a998e8	15	82	82	0	1	1	0
c1452f4c6fa	19	5155	2600	2555	187	14	5
8f221bc43d0	21	452	235	217	209	0	0
ea8feced871	22	40	40	0	2	1	0
849c92fec78	20	77	50	27	1	0	0
4b5e6a38df2	21	1138	928	210	156	2	0
3c5ea410ca5	01	167	167	0	3	2	0
f6f176e1087	16	2891	1709	1182	286	22	4
f153d6da450	20	80	80	0	2	1	0
97813ae58d1	17	37	37	0	1	1	0
653d4db71f5	17	151	150	1	2	1	0
b97c28f59ee	19	156	151	5	2	1	0
085dd30e93d	22	153	148	5	4	1	0
a555992d5eb	22	20	0	20	1	0	0
d9b4cc323f4	22	285	0	285	7	0	4
9c65387673e	11	189	0	189	1	0	1
ebeae2df518	19	4058	2198	1860	155	10	1
b30a03eda02	00	58	51	7	4	0	0
39aafcf801d	01	4	2	2	2	0	0
6808706c3b8	00	19	17	2	2	0	0
a5dba82ee21	23	103	100	3	4	1	0
1be09dfc258	00	861	454	407	234	3	7
1da7bcc22ca	20	55	54	1	2	1	0
15a5a4a9453	01	26	18	8	3	0	0
689e5c9d3db	01	23	21	2	5	0	0
9ef9a9dee54	21	119	55	64	1	0	0
4631c503e35	01	81	44	37	2	0	0
906a175a0b4	22	102	101	1	3	1	0
cb53cfd8b58	22	3	0	3	1	0	0
00a1d3633c3	00	3	1	2	1	0	0
01f3b468a91	05	38	20	18	1	0	0
fbb963b5d52	16	2	1	1	1	0	0
02eb9c834a1	02	2	1	1	1	0	0
73d328de248	02	2	1	1	1	0	0
ba72f8cad87	01	2	2	0	1	0	0
ee695e935df	00	46	35	11	1	0	0
a3da3e73121	21	62	62	0	2	1	0
645418e9f18	17	47	37	10	2	0	0
1df77a74389	02	42	42	0	2	0	0
eef552774e1	00	128	108	20	4	1	0
8a9434c4ef9	18	3	3	0	1	0	0
26a8c0c6b8f	00	4	2	2	1	0	0
85d6b783432	00	1	0	1	1	0	0
545807918ee	14	89	85	4	2	0	0
a66d2400a09	19	74	74	0	1	1	0
0e043528a1b	19	4	2	2	1	0	0
50b4c905a44	15	25	24	1	1	0	0
5abdef790c5	15	15344	5267	10077	355	20	49
f73ee94d4f5	00	4	2	2	1	0	0
1f9f8634941	21	8	4	4	1	0	0
df23ce138fb	18	18	6	12	2	0	0
7c9b607048f	18	108	101	7	4	1	0
e3157972e1f	15	73	34	39	1	0	0
da93d6adfb0	15	165	142	23	3	1	0
ce3d18412c9	05	87	63	24	2	1	0
255650f4d97	22	90	67	23	2	1	0
7304a620ecc	21	63	54	9	1	0	0
e6c81bd6798	01	171	157	14	3	1	0
1eedbdc361b	04	116	95	21	2	0	0
65f6f06a61c	03	123	117	6	2	1	0
c0e70354dbf	00	25	16	9	1	0	0
967b5dbb453	02	97	50	47	6	0	0
12cd13312b1	17	9	9	0	1	0	0
6942a95ae18	21	2	1	1	1	0	0
366baedfd8b	20	265	218	47	0	0	0
f4b1e00071c	19	170	85	85	2	1	1
32fdae2ca3b	19	5	3	2	2	0	0
bea9dfa14c5	21	8282	8086	196	144	37	0
22c68fdc1da	21	828	439	389	38	0	1
993bb93e0a5	23	96	73	23	6	1	0
4bf52118209	20	8	4	4	1	0	0
ff0de45929a	20	2582	1329	1253	187	3	8
0f8de5e1f96	01	634	433	201	11	2	0
bd5ab9c601f	22	23	19	4	1	0	0
04e0324f6a8	00	2	1	1	1	0	0
db5776cf8b5	23	1512	1119	393	2	0	0
e48536f4cda	03	7	4	3	1	0	0
33d746c656d	22	23	19	4	1	0	0
5e86519199b	20	1035	127	908	111	0	5
9da67fa5198	15	113889	33691	80198	1823	321	1426
ff8a4058bfa	15	61355	30454	30901	663	304	305
b3b8e74dbf6	22	32	32	0	2	2	0
8bac8857f5c	20	163	139	24	14	1	0
f5602bda181	20	38404	3280	35124	1243	17	997
99a7e78e778	16	69	69	0	2	1	0
831de7cbb91	23	30	13	17	3	0	0
49519f12178	01	214	128	86	9	0	0
40e92650bb9	21	165	136	29	5	1	0
9fc9b874728	22	157	149	8	3	1	0
6176e49181f	21	12	9	3	1	0	0
2a8c5ddc468	00	101	101	0	1	1	0
7c17ca203fe	00	6	3	3	1	0	0
bd54fd3553f	00	95	95	0	2	1	0
478c7d2993d	00	23	23	0	3	0	0
b3551f038f5	00	35	35	0	1	1	0
38c0c47bbe2	18	55	53	2	1	0	0
4bc024ddecf	17	778	614	164	27	3	0
ccad4c7fbc1	16	4	2	2	1	0	0
c86b3815b53	18	478	295	183	18	0	0
1111880df4d	15	496	197	299	20	0	0
67cb80158ce	18	67	67	0	1	1	0
637acb2b348	18	4	2	2	1	0	0
a088cf4f930	16	20	18	2	1	0	0
9195455637b	16	2262	1962	300	144	35	0
3c7945bda10	22	82	81	1	2	1	0
0a4260c8c0d	01	4	2	2	1	0	0
5613803f8db	17	0	0	0	1	1	0
fc71a63bafd	17	7	0	7	2	0	0
4bca631c1a5	20	7	7	0	0	0	0
87654360250	20	59	59	0	1	1	0
1a39380ab4c	20	4	2	2	1	0	0
0b9bdb2bc7e	18	11	9	2	1	0	0
fc4b4059ff3	18	70	70	0	1	1	0
17d00f16574	18	4	2	2	1	0	0
d9d5bc46545	17	23	21	2	1	0	0
e8500274e04	00	46	18	28	6	0	0
a0837fd32e8	18	653	460	193	116	1	0
49d9ad9d81e	17	653	460	193	116	1	0
4d13fcf4811	21	14751	126	14625	221	0	124
bf16141eeb0	21	15080	353	14727	322	3	124
e0519ace315	06	143	141	2	2	1	0
6ada73383cf	21	4	2	2	1	0	0
59c8f591713	21	63	63	0	1	1	0
25e51c396aa	19	15	13	2	1	0	0
96c30df10cd	19	178	113	65	8	0	0
f28f67cf759	18	539	332	207	203	3	0
51226b84cf5	18	11	11	0	0	0	0
e116ee7ba13	18	4	2	2	1	0	0
0a763e35da1	18	63	63	0	1	1	0
99fe35c67a1	18	67	67	0	1	1	0
6fad535c639	18	4	2	2	1	0	0
c1a1ab06772	23	15	13	2	1	0	0
71091f78f20	23	61342	41224	20118	627	304	26
ba0ed00b5f3	20	167	110	57	2	0	0
5dd91b01471	23	1	1	0	1	0	0
5dc51d4e215	20	119	86	33	2	0	0
df6ffc018ef	17	83	82	1	2	1	0
ce54f4ae50a	18	4	2	2	1	0	0
878ffdbe6a8	17	22	20	2	1	0	0
c86afa5d2ee	17	21413	20524	889	266	155	0
f523f7041dc	19	54	43	11	4	0	0
f904d614bf6	22	75	75	0	1	1	0
ccb77e1c9d5	22	4	2	2	1	0	0
30d9e9fdd9d	21	28	26	2	1	0	0
179aa0a8f2c	22	1	0	1	1	0	0
074e823a81f	21	229	115	114	106	0	0
1314c4aeeb9	21	166	135	31	7	0	0
9c7078cea2b	15	14	0	14	1	0	1
a2f93cf77a8	22	97	96	1	2	1	0
52adc0d9630	18	6	3	3	3	0	0
896b2aa7074	22	481	296	185	16	1	0
3a2b5030ae1	00	33	21	12	2	0	0
f57ff787aaf	23	3	1	2	1	0	0
77de2070893	21	65	65	0	1	1	0
bae6d089a4d	21	4	2	2	1	0	0
d2fdae197ac	20	19	17	2	1	0	0
199fa9f8ddc	20	2	1	1	1	0	0
f564b6b58ae	21	654	470	184	16	2	1
f7b10f54452	21	42080	21775	20305	481	149	26
ca38def146c	21	65	65	0	1	1	0
ef2b2a3f520	21	4	2	2	1	0	0
a241deb19a6	01	15	9	6	2	0	0
5deb1672f2b	18	22	20	2	1	0	0
c1e8c8de1cd	01	18	12	6	1	0	0
430dc39e87d	22	88	49	39	2	0	0
a1eacdf12ae	19	154	102	52	2	0	0
119354f7356	17	653	86	567	2	0	0
4e8cddddcbb	17	97	7	90	1	0	0
69dac92c36b	22	80	14	66	2	0	0
64fc34b2700	22	703	703	0	3	2	0
3058f08e645	22	14	0	14	1	0	0
d5158574c6c	19	19	16	3	2	0	0
bdb78b9945f	22	35	24	11	3	0	0
0b8af89363f	22	2	1	1	1	0	0
201baa273b1	21	167	164	3	3	2	0
6a833a38f6a	18	87	87	0	1	1	0
458c8bb9f86	22	4	2	2	1	0	0
5d3dc0e4c33	21	66	54	12	1	0	0
31e73a5cecd	21	274	146	128	110	0	0
fc58a5d4bdf	00	42022	21737	20285	477	149	26
5e9c7a92f20	23	12	2	10	1	0	0
fede68fd689	22	1031	637	394	30	2	2
4b69bcfc66c	22	53	32	21	11	0	0
ec576235f1f	21	116	16	100	1	0	0
a58454226f4	20	137	132	5	2	1	0
c38ce9bc0a1	19	61	53	8	3	0	0
0e21d7b9859	16	62	61	1	10	0	0
dda7b402044	14	4	2	2	1	0	0
7bd8a5a2a60	05	12	12	0	1	0	0
9cfc92979b6	06	11	5	6	1	0	0
8e56b4dd1ca	21	17	17	0	0	0	0
72cf499b549	21	73	73	0	1	1	0
ec5577cf9da	21	4	2	2	1	0	0
deeaf8fab97	01	31	29	2	1	0	0
ff99cd52777	00	183	83	100	6	0	0
c77747354c5	17	15	7	8	1	0	0
025f9133bbd	15	91	89	2	3	1	0
4dc5b13861d	15	91	89	2	2	1	0
01e29202193	15	97	95	2	2	1	0
1d794ec43e5	15	5	4	1	1	0	0
4bf1d1007fb	15	76	63	13	2	1	0
c77312405e0	23	2	1	1	1	0	0
50624a50ee4	17	7627	1078	6549	98	1	16
0b04abcb10a	16	14	5	9	1	0	0
e4406b76dfc	16	4	2	2	1	0	0
223f22a30d0	16	79	79	0	1	1	0
56e90dacb39	16	85	85	0	1	1	0
4babd2b46eb	14	36	34	2	1	0	0
42b8682a518	15	5	4	1	1	0	0
881ef7cc5fc	23	8	4	4	2	0	0
17a379ec39a	18	16	13	3	2	0	0
8ee43006b81	03	2	1	1	1	0	0
b0de1e4a416	22	203	180	23	3	1	0
440bc060b98	18	4	2	2	1	0	0
22c7d134e27	18	9	5	4	2	0	0
50be39792af	18	6	3	3	1	0	0
9712aa9f760	16	41	38	3	1	0	0
1ccae9cb1bd	16	36825	34399	2426	317	196	13
e5fdc4d6f1a	16	402	293	109	23	1	0
67096fdb38b	00	69	69	0	1	1	0
49dcab933bd	00	4	2	2	1	0	0
c67f8d0500f	23	23	21	2	1	0	0
f2f893b2a7e	23	38229	35495	2734	453	206	13
b2587b26786	23	61	59	2	2	1	0
c93af860a07	18	50	44	6	2	0	0
e4b716efaa0	15	15	10	5	2	0	0
1fd95b57bf5	18	2	1	1	1	0	0
aeef9518c6e	18	70	11	59	1	0	0
0f460b03f31	18	77	77	0	1	1	0
734a19060c0	18	4	2	2	1	0	0
d4982f6f5e4	17	30	29	1	1	0	0
88686aa4106	22	72	55	17	2	1	0
d46ebffb66e	17	939	726	213	209	9	0
b319264d849	17	36	24	12	1	0	0
4716dc662d8	16	24	10	14	1	0	0
234fb122bbd	00	77	75	2	2	1	0
164d5b34655	01	6	6	0	1	0	0
7af075ee304	16	18	9	9	1	0	0
1d17ced200c	21	86	86	0	1	1	0
46da8c2da6d	21	4	2	2	1	0	0
f1fa7566810	21	4	2	2	1	0	0
bce38b3d74e	20	42	40	2	1	0	0
9100dd4b0fa	20	4	2	2	1	0	0
708e8589ea7	20	87	87	0	1	1	0
61d254ebdcd	20	4	2	2	1	0	0
1e0de9c426e	18	41	39	2	1	0	0
dea0634f608	18	301	218	83	18	1	0
929e4d9c9a0	05	26	25	1	2	0	0
eafa902632b	21	99	96	3	2	1	0
5ae26f3750f	01	170	153	17	1	0	0
61935bc167c	16	20	15	5	2	0	0
2eb847849fc	17	2	1	1	1	0	0
c0d500102a0	01	73	72	1	3	1	0
92cc1878812	16	82	82	0	1	1	0
9d3a09f9a8c	16	4	2	2	1	0	0
c274d164358	01	36	34	2	1	0	0
3dd7938c033	00	585	361	224	120	0	0
008ab12b7fa	23	5	4	1	1	0	0
d9036a5d35d	20	92	46	46	1	0	0
425163e0d6a	20	584	292	292	1	0	0
14947b6c5e1	23	98	97	1	2	1	0
3537b57f3e6	23	24	0	24	1	0	0
c0721bcd668	21	105	99	6	4	1	0
d62cf59dc15	14	67	67	0	2	1	0
5e140b33e58	22	72	32	40	3	0	0
6399839c398	22	5	0	5	2	0	0
6bd8b7e5405	21	45	34	11	2	0	0
110cacd1ed7	18	12	6	6	2	0	0
53f2381455a	17	2	1	1	1	0	0
7a07b31a2f6	17	2	1	1	1	0	0
228ad9357c0	15	487	487	0	1	1	0
e2b293c360a	15	4	2	2	1	0	0
163ca274230	17	37	35	2	1	0	0
327b6e3e1de	02	153	131	22	15	1	0
cd2b9f542c3	18	27	22	5	2	0	0
e2400f88d85	02	59	58	1	2	1	0
21a99664aed	02	5	3	2	2	0	0
12713c3bb78	17	18	9	9	2	0	0
31b5d41f57c	17	13	8	5	1	0	0
80472bc3012	15	46	41	5	2	0	0
43c1830e0a9	05	4	2	2	1	0	0
4d1e9e53702	05	4	2	2	1	0	0
7c9ff8e94a0	04	2	1	1	1	0	0
6e34dfd9e80	02	11	11	0	1	0	0
98c6a817715	17	10	9	1	1	0	0
8cf2d4c2c16	17	10	2	8	1	0	0
f5c293b5ed6	16	13	7	6	1	0	0
9826159bf10	00	3	2	1	1	0	0
99a2059e40a	00	5	5	0	1	0	0
6076a25e80e	23	2	1	1	1	0	0
08f5db112f9	22	20	9	11	1	0	0
6d593a90268	20	23	18	5	1	0	0
b3cbb16f41f	15	110	93	17	3	1	0
29cd0f2a77f	19	99	94	5	2	1	0
632b7d8750a	22	52	1	51	2	0	1
ea30ca95335	21	181	181	0	0	0	0
90368770e6a	15	2	1	1	1	0	0
4b47bb4dbc8	02	209	123	86	7	0	0
e7b8bad3d98	19	8	4	4	1	0	0
f23ec6b3cfd	23	27	6	21	2	0	0
9c5812574f3	00	62	62	0	1	1	0
5c3c2ed9453	00	4	2	2	1	0	0
67a4cb4fe8c	23	16	14	2	1	0	0
80fb580936d	23	1267	934	333	228	9	0
277a2545d26	22	367	312	55	1	0	0
7df4652d7be	21	4	2	2	1	0	0
ff2639f9eac	21	2	1	1	0	0	0
116d6c44025	21	107	107	0	1	1	0
0debf5a8293	20	55	53	2	1	0	0
51c8b0ede3a	20	45	27	18	4	0	0
81c278d58d8	20	635	480	155	36	5	0
d258fb02125	07	186	183	3	3	1	0
db5d58e8425	20	101	63	38	1	0	0
9208c890582	17	32	27	5	2	0	0
a978bedee79	07	70	70	0	2	1	0
b0f6789a78d	06	34	10	24	7	0	0
d5a0940fff9	06	9	2	7	2	0	0
8c44869f1dc	06	74	74	0	2	1	0
e0cec37d50b	01	36	20	16	1	0	0
32ac8c0b69d	01	11	9	2	1	0	0
5038f401853	01	19	17	2	4	0	0
74784b63d62	09	13	9	4	3	0	0
312289b791a	03	16	11	5	2	0	0
426b4c62580	03	198	100	98	16	0	0
cd68d86c328	03	138	69	69	8	0	0
049903e333f	00	316	165	151	3	0	0
e4383c01708	23	4	3	1	1	0	0
119cbf48542	00	45	34	11	3	0	0
e428bb7eaea	23	40	25	15	6	0	0
384f1be739b	20	53	37	16	2	0	0
f5d84965d78	00	2	1	1	0	0	0
5222d19a11e	20	51	37	14	2	0	0
63edde0e01e	23	16	13	3	2	0	0
d345c1173ac	19	4	4	0	2	0	0
4ac73d2c99a	19	2	1	1	1	0	0
2106ef000c7	18	183	179	4	4	2	0
fc229860232	22	7	7	0	1	0	0
be770a3839f	19	88	88	0	1	1	0
33aafbd8822	19	2	1	1	0	0	0
4cda016c264	19	4	2	2	1	0	0
83392403b7a	17	53	46	7	1	0	0
687522c5a51	18	3	2	1	1	0	0
0928a526dd5	17	215	149	66	5	0	0
55aa973bee0	16	23	12	11	3	0	0
4926ffd14be	23	226	210	16	1	0	0
88644eaa2db	23	231	105	126	20	0	0
4b67f0be6d6	03	14	11	3	1	0	0
7764b842974	00	164	83	81	1	0	0
875e4a0c59e	19	65	43	22	8	0	0
95862b23802	19	26	13	13	2	0	0
86433979c6f	06	31	31	0	2	0	0
586e160a258	01	3	2	1	1	0	0
1b870b61277	01	188	94	94	2	1	1
937662b03e5	01	5	4	1	1	0	0
ec378aaa690	00	260	39	221	3	0	0
57f9f048d30	01	31	23	8	1	0	0
30e5366b296	00	7	5	2	1	0	0
88befa6021d	16	7	3	4	2	0	0
82357b87eb1	22	2	2	0	1	0	0
fafb67c65bb	21	2	2	0	0	0	0
f8ae4446ee7	21	84	84	0	1	1	0
33e8e694e87	21	4	2	2	1	0	0
530d8c05d4c	18	16	14	2	1	0	0
ff540e19a4d	21	15	8	7	1	0	0
b0e7dbf2c0b	17	3	2	1	1	0	0
34046084c06	00	103	29	74	4	0	0
e03bc472f0b	00	19	16	3	3	0	0
74c08403d89	00	2	1	1	1	0	0
27d1babaae3	19	64	62	2	4	1	0
f9a0140ef14	18	34	19	15	2	0	0
a63c28e6eb9	22	121	110	11	2	1	0
3b2e9d26480	18	268	76	192	19	0	0
089ec586135	20	20	14	6	2	0	0
bbcb8b3ae09	18	18	13	5	2	0	0
053e02ef8e4	17	2	1	1	1	0	0
bd4d585b7a9	00	106	106	0	1	1	0
4b80f217cd9	23	22	11	11	11	0	0
2ed56e52354	22	570	285	285	20	10	10
1eb6a92984d	22	6	4	2	0	0	0
06fbcca6bb1	22	88	0	88	1	0	1
ef08f0fbb19	20	51	26	25	3	0	0
e850cbab1c8	20	5488	5488	0	23	26	0
035aa6b4cef	18	2	1	1	1	0	0
087c4379617	18	30	26	4	1	0	0
7658f4c29c1	08	11	10	1	1	0	0
0e59efd079d	07	28	27	1	0	0	0
7d517458278	07	31	0	31	1	0	1
0a406869df9	02	137	74	63	2	1	1
bafc51c0f9b	22	149	63	86	2	1	1
8c719f7c71e	05	3	1	2	1	0	0
8a3f52170e1	05	109	0	109	1	0	1
2a64edb025b	18	78	78	0	1	1	0
1fc6f993402	05	87	87	0	1	1	0
6d116be7cf2	07	120	48	72	2	1	1
844b33205c7	07	33	18	15	2	1	1
2a2942bd7f3	07	22	16	6	2	1	1
fef35fc4f1d	07	15	0	15	1	0	1
3761be3d99f	07	45	40	5	2	1	1
7e5cd08061d	06	38	21	17	2	1	1
f7a4ccb409c	06	81	40	41	2	1	1
44be55fc4e4	06	44	25	19	2	1	1
4e1bcdcab9f	02	139	62	77	6	5	3
e87ed91face	21	81	48	33	3	0	0
3f67a48dd46	06	161	57	104	2	1	1
56b22956ad3	22	48	0	48	2	0	2
048f7fd37ce	22	8	3	5	2	0	1
55aa2571a0f	07	291	91	200	4	2	2
419607e8ebc	21	23	17	6	2	1	1
cc38528acf9	21	63	36	27	2	1	1
921c3c2097f	21	66	40	26	2	1	1
3b16657e775	07	80	40	40	2	1	1
536ce446898	07	80	69	11	3	2	0
d5d04a51d64	01	80	0	80	1	0	1
051c1317f99	06	45	0	45	2	0	2
e82f97401f9	03	776	711	65	6	5	0
baea73ccda8	03	228	114	114	2	1	1
aa2edd4b89c	07	116	116	0	1	1	0
37077de83db	07	59	52	7	1	0	0
dd069a25394	07	42	41	1	1	0	0
00e1962495f	03	110	110	0	1	1	0
32674645860	22	84	84	0	1	1	0
727151afd31	21	4	2	2	1	0	0
54d20ffba03	21	39	37	2	1	0	0
4911a30803e	21	264	132	132	105	0	0
60238cce12d	19	4	4	0	1	0	0
7f303707d5b	02	2	1	1	1	0	0
a77c29a0f98	02	18	11	7	2	0	0
75df612cd7e	19	12	8	4	1	0	0
09b12122544	18	2	2	0	1	0	0
8476aefc8e2	20	102	97	5	2	1	0
9299168f2a2	02	6	3	3	3	0	0
95ac576bf95	22	132	53	79	4	0	0
3f38069acfa	19	62	62	0	1	1	0
01bff7e7a7b	19	4	2	2	1	0	0
e10c75579b5	17	16	14	2	1	0	0
73be4608d9d	18	849	663	186	131	5	0
987338fe31b	23	109	108	1	2	1	0
c9dcf5718cf	16	152	151	1	2	1	0
2789323902a	17	56	54	2	2	1	0
82ad5fbe9aa	00	1	1	0	1	0	0
6dcadb9fc86	20	133	133	0	1	1	0
02374d0c178	23	92	92	0	2	1	0
1762dd7ed98	23	10	10	0	1	0	0
6bd450155c3	23	2	1	1	1	0	0
862b1642091	04	12	4	8	3	0	0
e4a856e0ba8	01	33	19	14	4	0	0
0c2e5ec840e	01	434	379	55	21	2	0
2810b1ab00f	18	4	2	2	1	0	0
e4d97b1dca5	18	78	78	0	1	1	0
c3c8eee46db	18	4	2	2	1	0	0
4b9f0d190cd	17	33	31	2	1	0	0
33b2aebb6dc	16	15	13	2	2	0	0
13897279ae1	17	72	72	0	1	1	0
ccf2712ee55	17	4	2	2	1	0	0
53978bdf420	16	27	25	2	1	0	0
5aef65a98a9	16	2916	2153	763	269	10	5
9a488a667cc	19	8	5	3	1	0	0
916aebabb83	23	6	5	1	4	0	0
c7c1ed01ae1	18	4	4	0	1	0	0
a6c18472cd3	21	143	88	55	2	0	0
7e1cf84c9ef	19	106	99	7	2	1	0
016810913d4	07	56	41	15	2	0	0
f64d1febc88	07	2	1	1	1	0	0
60f18ede39e	01	60	56	4	2	0	0
bda45a8be1e	01	92	7	85	2	0	1
02f7d1bfd8b	19	92	85	7	2	1	0
4c78a52a3a0	16	3	3	0	1	0	0
faf78604ca9	16	3	3	0	1	0	0
e26622bd18f	19	138	87	51	2	0	0
bdc7251b64b	22	25	14	11	1	0	0
15508589a16	23	65	52	13	6	3	0
72dd3b4e252	01	43	37	6	1	0	0
7f6054ca81f	18	74	74	0	1	1	0
f64742ea07d	18	4	2	2	1	0	0
6e05faa3d0d	18	81	81	0	1	0	0
5f2f8400f66	17	30	28	2	1	0	0
e722ca32d98	17	1800	1406	394	138	5	0
7a2ebce8d8e	17	16	6	10	3	0	0
80242528778	16	206	196	10	14	1	0
5d3c51d937f	03	75	75	0	1	1	0
782149ddc3c	01	93	77	16	2	1	0
539bf1d7b70	00	12	8	4	2	0	0
9c2c8454634	20	67	67	0	1	1	0
4598a4c6dd2	20	4	2	2	1	0	0
2c4eef0d972	20	21	19	2	1	0	0
4d32fc59642	20	862	561	301	123	1	0
fc3547bc828	19	4	2	2	1	0	0
1c35ee8695a	19	81	81	0	1	1	0
9e7bebeb830	16	35	33	2	1	0	0
ee2fd79e434	18	12	3	9	1	0	0
01a4be45542	18	24	24	0	1	0	0
0459a602327	16	862	561	301	123	1	0
ae6f4b32c47	22	1	1	0	1	0	0
b7d76a1a7ba	21	130	44	86	4	0	1
1528de23735	17	46	42	4	3	1	0
b48e303af02	19	130	86	44	4	1	0
47f3fc9a267	20	20	11	9	1	0	0
b9ffc537e66	20	6	3	3	1	0	0
14e8f806dec	00	97	95	2	2	1	0
20a3c5d09c4	00	21	21	0	3	0	0
27fafd46487	19	87	86	1	2	1	0
9a4a39fc97d	19	4	2	2	1	0	0
4c9de9d7169	19	87	87	0	1	1	0
9313fdc71ca	18	41	40	1	1	0	0
3383d77c61f	01	65	65	0	2	1	0
dc0c524ce68	02	4	4	0	1	0	0
9ece63b1d74	04	18	14	4	1	0	0
bc8feb151c7	04	22	9	13	1	0	0
840401c024a	02	7	4	3	1	0	0
b43e544140c	21	70	19	51	2	0	0
530585b2d10	03	54	9	45	1	0	0
a993f740f04	02	194	194	0	3	1	0
8e37a589a62	15	4	2	2	1	0	0
be54423782f	03	11	6	5	1	0	0
6d9ee4b1843	01	12	12	0	1	0	0
1388171d96d	01	67	67	0	1	1	0
daf46669636	01	4	2	2	1	0	0
c50c33e9397	00	26	24	2	2	0	0
aa742ddf80f	23	967	666	301	220	8	0
18c985919d9	22	2	1	1	1	0	0
321b8eec08d	20	92	46	46	1	0	0
38df9d51a22	20	586	294	292	1	0	0
3b715edda97	18	2	1	1	1	0	0
df3563aa65d	14	30	30	0	2	0	0
3e6f737eaf7	14	55	26	29	1	0	0
44ceb5d8f5d	01	82	82	0	1	1	0
30bd774fbd3	01	4	2	2	1	0	0
01994e8119c	00	38	36	2	1	0	0
6c80ef01c1f	00	52	51	1	4	2	0
7550e31d1ad	23	87	52	35	1	0	0
ecdde7df15f	05	1	1	0	1	0	0
e11668b244e	21	8	4	4	1	0	0
f423287453e	19	99	51	48	1	0	0
ba94f9d6f89	19	107	56	51	2	0	0
aec2f733f97	19	61	26	35	1	0	0
9785ab60574	17	12	6	6	1	0	0
1c2910d94c4	02	73	73	0	4	4	0
ec8ebaf3009	20	64	32	32	6	0	0
4401bb47bfa	20	231	129	102	5	0	0
4be9c695f0c	04	7	5	2	1	0	0
d76eacd4e61	23	4	3	1	1	0	0
54740c8b247	23	14	7	7	1	0	0
6738e685921	20	97	97	0	1	1	0
70eb227e80f	20	4	2	2	1	0	0
d86d83c75f6	19	60	58	2	1	0	0
982981442dc	19	8	4	4	1	0	0
244924823ec	02	134	116	18	4	1	0
0edd93dcc1e	16	3	3	0	2	0	0
fb915ed9573	16	17	9	8	2	0	0
c048c814c79	16	6	3	3	1	0	0
d30e76e0e83	16	84149	61342	22807	1173	1033	59
9d0103d22e1	00	44	22	22	1	0	0
0c867ae618e	00	35	25	10	1	0	0
ec7455558f6	23	31	26	5	2	0	0
825af451fbd	17	23	20	3	1	0	0
79ec9dc1dd0	02	12	7	5	1	0	0
f9caf7020c6	02	37	12	25	2	0	0
8624adf5d8b	02	83	35	48	1	0	0
836593da23f	22	34	22	12	1	0	0
9f4c0988c37	17	43	43	0	1	0	0
cab22644a5b	16	1	1	0	1	0	0
f63af64eb8d	16	45	22	23	2	0	0
f3f4e290e0d	16	2	2	0	2	0	0
43538f4f8fc	19	79	79	0	1	1	0
04adf0e5a1e	16	579	579	0	1	1	0
82c7c84e255	20	149	144	5	3	1	0
6c5356bfe26	16	119	5	114	4	0	1
945f877d304	22	3	3	0	2	0	0
cd51fa8f5a9	01	32	18	14	2	0	0
abbd47e4a37	18	100	67	33	2	0	0
3751c0fe40e	18	6	4	2	1	0	0
19ecc3a4a6e	15	60	43	17	21	0	0
0977638ffb0	17	18	15	3	5	0	0
1d369317ea4	06	142	68	74	1	0	0
81e356279dc	01	3	0	3	1	0	0
b4df1e62de1	06	39	28	11	3	0	0
bb56dcc4505	06	70	42	28	2	0	0
695abba5ac3	17	194	165	29	18	0	0
8a3befa0c65	05	484	259	225	1	0	0
7742257febb	23	2	1	1	1	0	0
854171dc6f2	19	3	0	3	1	0	0
20a88feb8fe	19	497	398	99	1	0	0
04541cf7bcc	06	4	4	0	1	0	0
8fe7b0c910e	06	17	11	6	1	0	0
5760244cc62	08	5	3	2	1	0	0
8f428f3b0de	23	5	4	1	2	0	0
fc7d8d59f75	18	4	2	2	1	0	0
f8bb031bdc7	15	12	9	3	1	0	0
dbcacc5afe4	02	5	4	1	1	0	0
99021b7a4f7	01	14	7	7	2	0	0
42981e2aadf	01	10	6	4	2	0	0
83704f12798	19	1	1	0	1	0	0
4a32d531555	22	51	42	9	1	0	0
e0c600e00e8	18	56	54	2	1	0	0
dd3ebb8cf64	17	20	15	5	1	0	0
e336134658f	23	36	32	4	1	0	0
175f78c6ba7	22	11	10	1	2	0	0
90de2ddb773	18	33	32	1	2	0	0
3d3a0b30466	15	3	2	1	1	0	0
70461c39be7	15	2	1	1	1	0	0
79fd9620f5e	23	3	2	1	1	0	0
0e01d6398f1	23	269	103	166	4	0	1
44b308b1f7b	00	518	197	321	4	0	0
d58f2654bce	06	13	12	1	1	0	0
49ea653363d	04	113	113	0	2	1	0
ac5a185edf1	18	45	26	19	1	0	0
53fa66d9f79	02	4	4	0	1	0	0
4b4ff2dff16	09	39	29	10	1	0	0
38e2b0053a0	02	39	29	10	1	0	0
b15e19a2324	04	123	72	51	3	0	0
2ff499c0229	03	108	86	22	2	0	0
c2f62d496a0	07	23	14	9	1	0	0
0118584433c	07	197	129	68	1	0	0
286c54439a6	07	19	15	4	1	0	0
62dd04027b6	07	2	1	1	1	0	0
f20fd22abd5	07	38	33	5	2	0	0
63ac07b32b0	07	4	3	1	2	0	0
58568232234	07	27	3	24	1	0	0
286aa04910f	21	114	61	53	1	0	0
f624ccb475a	18	24	23	1	1	0	0
cf0b4ba4105	17	4	2	2	1	0	0
acfb0ef908a	04	1	1	0	1	1	0
e82d06bef9c	00	3	1	2	1	0	0
f3e71eb4170	00	98	98	0	1	0	0
71e2b61388e	00	41	36	5	1	0	0
0678480b572	18	28	20	8	1	0	0
545f5126190	21	18	18	0	5	0	0
9b1b85490b6	20	1247	1247	0	6	6	0
8acb416ad05	20	150	99	51	3	0	0
06e321d0f96	14	8	4	4	1	0	0
02f017d24f8	14	18	11	7	2	0	0
caa853bb06c	23	16	15	1	1	0	0
3b59fd70f4e	20	119	103	16	2	0	0
9b5abe5bfe3	23	87	71	16	1	0	0
51a52c43a28	00	5	3	2	1	0	0
639fbe28d11	23	2	1	1	1	0	0
420e07c5777	22	833	829	4	7	5	0
17834ed28cb	23	4	2	2	1	0	0
372cb32dc49	23	2	1	1	1	0	0
314c6b30603	00	7	7	0	1	0	0
45cdb0e4c12	19	65	65	0	1	1	0
953673424ae	19	4	2	2	1	0	0
1c9c6277d5c	22	19	17	2	1	0	0
ea355b6af7b	22	19	17	2	1	0	0
b09f97068e9	22	4018	3712	306	235	22	1
92e92b02155	00	4	3	1	1	0	0
0e95ea42cee	00	2	1	1	1	0	0
33fa7405778	00	172	158	14	2	1	0
4de274cbee9	02	8	2	6	1	0	0
3149d2f7dce	19	95	95	0	1	1	0
122ac4e1f21	17	71	71	0	1	1	0
e773be6f908	17	4	2	2	1	0	0
fdf91afb494	20	25	23	2	1	0	0
fb5c7f03a04	20	613	597	16	8	9	0
db008f7cce0	20	422	221	201	198	0	0
e2bcff9aa75	18	7	3	4	1	0	0
a12c42ca2f8	00	2	1	1	1	0	0
07d3b21f435	17	31	21	10	2	0	0
21c741f2576	17	130	129	1	5	4	0
5f0a10ad218	21	11	6	5	1	0	0
7fe16717276	21	82	82	0	2	1	0
54e88b3d619	21	4	2	2	1	0	0
b00527fcf05	20	9	7	2	1	0	0
45a13d96747	20	47	45	2	2	1	0
d130bb060eb	19	72	72	0	1	1	0
648e38771e5	19	4	2	2	1	0	0
ff4c974873f	18	59	41	18	1	0	0
e1bdde05c7e	16	4	2	2	1	0	0
822e13d375e	16	284	168	116	105	0	0
c7b2e29e5e4	14	9	4	5	1	0	0
78dbb15858f	17	4	2	2	1	0	0
82a72e9591b	17	87	87	0	1	1	0
1ed4c6776e4	19	39	38	1	1	0	0
abf37c1e665	16	4	2	2	1	0	0
a0ee2915665	18	186	108	78	6	0	0
95c9305874f	18	436	301	135	21	2	0
76a6c4bf2e3	18	478	295	183	18	0	0
29d12c73420	18	570	254	316	24	1	0
7413df0c1fd	18	302	175	127	111	0	0
1122e3af289	16	58	29	29	1	0	0
f2fa97f178d	17	108	46	62	1	0	0
d7da20c812c	17	20	15	5	2	0	0
f3621359f48	17	3	1	2	1	0	0
c87b524c5f4	17	294	141	153	2	0	0
76b0bdf7207	17	1075	928	147	8	1	0
4266f5cf2eb	01	5	4	1	1	0	0
bfb9d5bbe61	00	952	178	774	4	0	0
9901b69c8e3	22	401	316	85	4	0	0
627f0d27e82	17	2	1	1	1	0	0
8509073458f	18	7	4	3	3	0	0
58db21e6c55	15	4	2	2	1	0	0
b3536ae0a8a	15	73	73	0	1	1	0
061f2075cf8	22	134	132	2	7	1	0
38c72d4e295	21	27	25	2	1	0	0
218f08dbdeb	21	3885	2401	1484	239	17	5
99b2368a6cd	15	34	33	1	1	0	0
836a06fc4f4	00	74	2	72	3	0	1
b90c1502e53	21	8	1	7	1	0	0
fa912c246cd	22	2	1	1	1	0	0
d3e818cf8fd	17	13	13	0	1	1	0
3053f4d27d6	17	8	4	4	1	0	0
5a0056703af	16	12	4	8	1	0	0
c08320c957f	20	98	48	50	1	0	0
dcc01df968c	17	63	63	0	1	1	0
9877b8f4143	17	4	2	2	1	0	0
e1f39468fa5	16	7	6	1	1	0	0
8ca44f99285	22	93	93	0	1	1	0
37869f1c9a5	22	4	2	2	1	0	0
0bc273da4fc	15	53	51	2	1	0	0
ea2ceb731ca	18	13	10	3	1	0	0
411d46087f4	18	2	1	1	1	0	0
2a9a5e23188	18	2	0	2	1	0	0
83d39c8d535	15	42216	525	41691	541	6	431
04005716765	22	90	85	5	3	1	0
d77c24de3f8	22	10	4	6	2	0	0
3411a03dd11	22	39747	27733	12014	376	61	1
d406a8250f8	01	4	2	2	1	0	0
43a2b291822	01	95	95	0	1	1	0
6e205588909	04	54	52	2	1	0	0
22974a1acd0	23	4	2	2	1	0	0
15101163377	22	14	11	3	1	0	0
b788c5e77b5	22	1081	982	99	23	3	0
7144be70db2	18	411	231	180	2	0	0
362189a5d35	18	4	2	2	1	0	0
d80de98e910	18	97	97	0	1	1	0
b88c3902b24	15	49	47	2	1	0	0
1c2982b94f4	17	4	2	2	2	0	0
6e0b8b169c1	15	2	1	1	1	0	0
e35cec5c05f	15	2	2	0	1	0	0
005ae232502	15	10	10	0	1	0	0
41e1b171ec6	22	2	1	1	1	0	0
54a4c639e97	16	44436	43728	708	649	441	5
dec16aa5c2e	19	106	106	0	1	1	0
0ef1e5b5eb3	22	116	116	0	1	1	0
459717efb62	22	4	2	2	1	0	0
e6ce259d2ca	15	69	67	2	1	0	0
985e3a25cb9	19	8	4	4	3	0	0
e5d95ba939d	19	32	32	0	1	0	0
05282588e00	19	51	51	0	3	0	0
1597ce0eb3c	22	72	36	36	1	0	0
0407ecfcfbf	19	77	77	0	1	1	0
0ccdedab795	19	4	2	2	1	0	0
a299c97bbc7	08	30	28	2	1	0	0
c259499945a	08	228	119	109	103	0	0
ee200942dd7	16	2	1	1	1	0	0
2f1985ca7dc	00	212	106	106	101	0	0
024f4b12a55	23	263	152	111	104	0	0
2bcb9ab7bcd	22	2424	1376	1048	169	9	12
060141c58a7	16	104	81	23	3	0	0
b7223abbdc9	21	14	6	8	2	0	0
73976b6c9dd	21	23	14	9	4	0	0
226d37bb688	01	8	4	4	1	0	0
c0558ff7748	00	1	1	0	1	0	0
073c7b4d083	00	4	2	2	1	0	0
b6cf0454a93	00	75	75	0	1	1	0
f640c5d35cb	16	28	26	2	1	0	0
24ff8f4c79f	22	99	64	35	5	3	0
86778607c94	18	2	1	1	0	0	0
afa57799e43	15	206	162	44	3	0	0
3ccee087597	03	4350	2958	1392	172	40	7
22804a9eb88	01	42	41	1	2	1	0
50c7d80fb0c	20	66	63	3	2	1	0
c82e2889e82	19	85	85	0	1	1	0
e8bc2edabf3	19	4	2	2	1	0	0
0544a586ca6	20	28	26	2	1	0	0
f11a3dfcd63	02	252	118	134	101	0	0
caf69aa91a9	20	1694	855	839	196	0	0
9badc002b4b	19	1	1	0	1	0	0
168a5557803	19	212	201	11	5	1	0
0414e14702a	21	2	1	1	1	0	0
4ff56aa15e2	21	2	1	1	1	0	0
7bb814f9db0	21	3	2	1	1	0	0
93be4ffd4b2	18	103	58	45	3	0	0
74d076caf18	21	3	2	1	1	0	0
99ad0561c04	18	107	62	45	3	0	0
a7f3288a87c	18	43	43	0	1	1	0
7e6dea46019	00	10	5	5	0	0	0
c527366caa4	15	11	11	0	0	0	0
2a1f022d207	23	11	10	1	0	0	0
2dcaef6efa1	21	4	2	2	1	0	0
55ddf54adf6	21	11	9	2	1	0	0
585388bbd8d	22	2	1	1	1	0	0
575c12bba3e	21	77	77	0	1	1	0
02dae998c35	21	4	2	2	1	0	0
9b86a4453f0	15	43	41	2	1	0	0
2dd710e7ea5	20	29	28	1	2	2	0
37537d5720a	15	116	116	0	2	2	0
f5c07b65a09	02	1345	875	470	227	11	1
fd56981b4c3	17	6054	3027	3027	78	0	0
f70be41d80b	17	104	52	52	1	0	0
f8dab6acb60	18	1	0	1	1	0	0
b3cf3f35fcf	21	196	166	30	6	2	0
b0c0111b042	19	234	231	3	2	1	0
b207e24bcd1	17	59	59	0	1	1	0
3d34590fbac	17	4	2	2	1	0	0
8656c2654e4	23	15	10	5	0	0	0
f98562fcd7d	23	24	22	2	1	0	0
7fd3cb666bd	00	3	3	0	0	0	0
5809426d758	00	12	6	6	1	0	0
e4c9c9f412c	03	49	39	10	3	0	0
2c487669f74	21	11	3	8	1	0	0
f4f0daa44d5	21	112	108	4	6	1	0
0a0002b480d	19	1527	1043	484	135	8	0
5bb2fe660ed	18	61	61	0	1	1	0
ec299a13291	18	4	2	2	1	0	0
f9b237f478c	21	28	26	2	1	0	0
e16d506a58d	17	4130	1978	2152	55	4	3
d9057cc090b	20	218	108	110	102	0	0
430d94ef85f	15	116	109	7	4	1	0
f6484842b37	17	71	71	0	1	1	0
02ff9741cce	17	4	2	2	1	0	0
60bf2d6cb33	19	42	40	2	1	0	0
0c91b0e48e0	16	288	164	124	8	0	1
845b9e92d8c	16	288	164	124	8	0	1
e1fb7b76e99	00	9	8	1	1	0	0
868ffed77c5	18	11	3	8	1	0	0
a0a0062d612	18	134	78	56	7	0	0
7397ab2cf13	18	328	176	152	11	1	0
c383befd257	18	1389	973	416	155	26	24
a52a44e0729	01	105	89	16	1	0	0
19ecc17e6b6	18	8	7	1	2	0	0
4e5fe2d45ae	01	134	113	21	3	1	0
0109a9f90ac	00	92	53	39	2	0	0
d6b78d0e376	23	48	48	0	2	1	0
b8d861556a4	00	50	0	50	1	0	1
ef1b7dd3d76	19	35	15	20	1	0	0
9d4362403c1	18	8140	7656	484	278	161	0
eb9b8f51dad	00	1589	1171	418	121	3	0
3ad07ed0b8c	00	2	1	1	1	0	0
b6e916db587	17	4	2	2	1	0	0
bf561c52a5e	00	51	51	0	1	1	0
952e5133791	23	19	17	2	1	0	0
17061d981ec	23	1	0	1	1	0	0
ae5a209b114	23	15590	10056	5534	389	95	28
fecebe1dbf2	00	14	7	7	0	0	0
71078f91ed0	17	4	2	2	1	0	0
a4da6300c8f	17	73	73	0	1	1	0
bf539f9bfd2	05	3	2	1	1	0	0
cc6084b9ac5	20	42	40	2	1	0	0
c4e9226bdb5	22	7	4	3	1	0	0
5b5c8b60052	21	121	93	28	6	0	0
c49888bd847	20	4	2	2	1	0	0
59a40fc8ed7	19	966	692	274	201	2	0
559a98f0d7f	16	107	57	50	1	0	0
bc718742620	17	77	77	0	1	1	0
2134aa3d5c6	02	46	44	2	1	0	0
40f70673c65	08	5	4	1	1	0	0
b919e298712	08	5	4	1	1	0	0
5193d592197	08	22	14	8	1	0	0
103921dac07	07	15	15	0	1	0	0
1747eeff1aa	05	5	3	2	1	0	0
3e0757c1012	05	2	1	1	1	0	0
3644b0bc963	02	37	30	7	3	0	0
c721604d254	02	1784	1539	245	127	14	0
f2a9ed48736	17	25	24	1	1	0	0
37bdd36d70e	06	13	11	2	1	0	0
21aa0df8b2f	22	7	5	2	2	0	0
42ea37afb2b	16	4	2	2	1	0	0
e3074689f50	02	16	13	3	2	0	0
78234740221	06	381	381	0	1	1	0
b07b3913045	14	4	2	2	1	0	0
8b8a7a7f9b4	17	31	29	2	1	0	0
9a7158de18a	14	2	1	1	1	0	0
8a946c2ee7a	17	199	157	42	4	2	0
38250f64032	22	203	102	101	98	0	0
2603cc564da	16	5	5	0	1	0	0
d34fea59e1b	15	65	60	5	2	1	0
91835966eb0	23	231	126	105	102	0	0
5565366a33e	14	203	175	28	7	1	0
de89bbb00cb	02	10	5	5	1	0	0
441e7928492	02	4	2	2	1	0	0
6014a62b3ec	02	2	1	1	1	0	0
ff2a1b86c31	02	11	8	3	3	0	0
8f1a38d9163	17	11983	11942	41	153	157	1
ddf52bd3473	05	1460	1460	0	28	28	0
5ec056633f4	23	56	56	0	2	1	0
fce7c958ed4	21	1	1	0	1	1	0
8988af58f41	20	6	3	3	3	0	0
48c3d200418	19	14	10	4	4	0	0
5b39929d47f	18	229	153	76	11	1	0
260695afd07	17	8	4	4	1	0	0
1d3d02c70df	17	59	57	2	2	1	0
e4017402ef8	00	6	3	3	1	0	0
a72120190a8	01	42	40	2	1	0	0
f105f2f2fd1	18	4	2	2	2	0	0
252f034b30b	01	2	1	1	1	0	0
6ba1c625cde	16	270	160	110	104	3	0
edb62dd9023	01	894	623	271	120	10	0
10fa526fa03	01	5	5	0	0	0	0
5cfe0b86d5b	00	2	1	1	1	0	0
1df222f179f	23	2	0	2	1	0	0
de65ba7aba0	22	48	48	0	2	1	0
0ef6cfd39be	17	8	8	0	0	0	0
d0111aa0c45	21	9	7	2	1	0	0
b0b707cb6e4	19	2107	1621	486	141	21	1
d614d161c7f	22	11	9	2	1	0	0
41421ff9da1	21	7	6	1	1	0	0
a90bc78534d	18	81	0	81	3	0	0
e74a733024b	17	6	4	2	1	0	0
bc18bf4ec0f	16	31	31	0	1	1	0
bdd57f07563	15	11	11	0	0	0	0
c49f3b5df69	19	8	5	3	1	0	0
2b15cf57dda	19	4	2	2	1	0	0
1f93aa5d5d2	19	46	42	4	3	0	0
911b0fddd34	17	6106	2576	3530	184	14	29
a111390c566	15	20	1	19	1	0	0
283d735e2b7	05	79	68	11	1	0	0
e72addcf8e7	00	20	18	2	1	0	0
412c1ab5bc2	19	258	166	92	2	0	0
a0a5c4c5af3	17	209	95	114	1	0	0
8bec3febd84	17	11	10	1	1	0	0
f70fa3bae61	17	4	2	2	1	0	0
dd85a8c1837	15	2	1	1	1	0	0
e733dc3bc3b	17	661	640	21	10	4	0
a11bf99ce0d	02	25	25	0	3	0	0
6ce013dd4bb	21	131	118	13	2	1	0
d53cdc5378d	22	93	93	0	3	1	0
25e8ea17e1f	16	2542	2541	1	36	39	0
427662c6e92	16	2542	2541	1	36	39	0
1358632e672	16	4	0	4	1	0	0
e9aa57e8bdf	15	4	2	2	1	0	0
8d9766a9dfb	04	49	47	2	1	0	0
76f6a4abb46	15	1	1	0	0	0	0
54a4f99c4e0	14	11	6	5	2	0	0
13198357e99	04	2780	873	1907	171	0	9
65242abc3bd	07	36	26	10	1	0	0
131a67e7efa	07	50	42	8	2	0	0
424bca15c8e	23	55	44	11	1	0	0
6332a4cf004	22	346	154	192	1	0	0
c08357c32fd	22	2	1	1	1	0	0
940a6863ead	15	27311	5156	22155	246	2	22
0435f9b28c8	18	2	1	1	1	0	0
43ff46becfd	22	2	1	1	1	0	0
46b09e41903	18	11396	4208	7188	186	0	11
c45522df4c1	22	4	2	2	0	0	0
f9abf5e0e22	22	4	2	2	0	0	0
1285cd90111	16	4	2	2	1	0	0
debf552ed2d	00	22	20	2	1	0	0
e5d3ea77719	00	4705	1090	3615	247	6	21
28e851c169a	19	25	22	3	2	0	0
b9e40fbaacc	00	4501	941	3560	237	6	21
cc36cc59999	18	23	17	6	1	0	0
04e484c4843	18	4	2	2	1	0	0
e0f5d8e86d6	22	8	4	4	1	0	0
7946ad26342	22	2	1	1	1	0	0
cbdf3393a21	22	8189	5052	3137	163	10	0
434404e3bbb	17	2	2	0	1	0	0
dc8b488bbe2	17	4	2	2	1	0	0
782277f11a7	05	55	53	2	1	0	0
8a411bae665	15	8	1	7	1	0	0
719376730d8	05	434	264	170	121	0	9
24de89bd0e4	21	290	130	160	20	0	0
75670d3f630	12	2	1	1	1	0	0
d0c010e39be	03	6	3	3	1	0	0
b48f7f7eacb	03	3	2	1	1	0	0
1a2255ab44d	00	141	70	71	2	0	0
ee6c11876aa	00	72	72	0	1	1	0
a3753b496e4	23	42	12	30	3	0	0
9fc7283a403	02	122	84	38	2	0	0
c393853b4e0	21	2	2	0	0	0	0
564172510de	21	6	3	3	1	0	0
3b95d88bf2d	17	2	1	1	1	0	0
2cca7488bf5	15	65	45	20	3	0	0
3f3f958c14c	02	32448	25604	6844	290	35	2
1665b4a2a3b	00	2	1	1	1	0	0
faa4d9ff5f7	21	203	116	87	1	0	0
f8519e10b82	20	6	3	3	1	0	0
9611354f08d	20	2	1	1	1	0	0
01103d077bc	00	2	1	1	1	0	0
a98e8455162	00	360	176	184	1	0	0
f19f980724f	17	4	2	2	1	0	0
4bc1d395de6	23	33	31	2	1	0	0
8068f9bf388	23	2	1	1	0	0	0
14a5b45c06c	00	10	8	2	1	0	0
ea4b1c1c0c2	19	96	66	30	4	0	0
9239088e873	00	2	1	1	1	0	0
07d8a4650e9	00	344	187	157	1	0	0
a811a4a1304	15	9	8	1	2	0	0
5979f096d1b	17	42	30	12	3	0	0
8c758e127c9	21	1	0	1	1	0	0
b4fbf6d2759	21	13	8	5	1	0	0
33a9ac60877	05	6624	3791	2833	289	0	14
1858d1c340c	02	8	8	0	1	0	0
3d84c3db257	22	96	53	43	3	0	0
1930772693d	22	116	58	58	2	1	1
eaf607e88b6	01	2	1	1	0	0	0
8cd2b0e778e	01	2	1	1	0	0	0
cd8f82c007b	00	24	14	10	2	0	0
1de43149bbb	17	286	153	133	1	0	0
a9fc63f7a18	17	38	27	11	5	0	0
0abe42a0f4b	17	4	2	2	1	0	0
e63c7821d5f	17	474	469	5	8	6	0
e4dd8dc28ef	17	8	7	1	1	0	0
2f93eb6102f	19	31	28	3	1	0	0
0a414f4caad	22	3	3	0	1	0	0
9164fa6aaaa	21	7	7	0	1	0	0
992e3464b89	20	4	2	2	1	0	0
4ced23deaf3	18	21	19	2	1	0	0
711ecdd54fa	19	3	2	1	0	0	0
aaf0453b7cd	18	398	197	201	190	0	0
719cd461d39	18	30	28	2	4	0	0
ab60efb5354	17	3	3	0	0	0	0
2fc528ce009	17	251	134	117	1	0	0
62c12d21612	17	38	27	11	5	0	0
e3ceee2dce6	17	4	2	2	1	0	0
91120e04297	17	469	466	3	8	6	0
b7e8e35c0ed	17	8	7	1	1	0	0
c9be1d5ffdb	19	31	28	3	1	0	0
fb400b48682	22	1	1	0	1	0	0
bce68134b64	22	3	3	0	1	0	0
bfe9cdb7f2f	21	7	7	0	1	0	0
acf19500eed	20	4	2	2	1	0	0
a1d193963dd	21	35	33	2	1	0	0
e5ef103b050	17	55	36	19	1	0	0
35bcb1d6a96	15	4	2	2	1	0	0
1ac05cc5ad6	22	1320	778	542	133	1	11
76de7c0c26e	14	19	11	8	2	0	0
c0a9985da7a	17	80	80	0	1	0	0
27dfb1d4c03	14	4	0	4	1	0	0
77c1cc04825	14	2	1	1	1	0	0
c9a231db0e5	02	2	1	1	1	0	0
605927fbd9c	19	2	1	1	0	0	0
33c76f19de1	19	2	1	1	1	0	0
0fcb1246022	18	4	2	2	1	0	0
c2b47097c0b	00	50	48	2	1	0	0
7b3fb22290c	02	2	1	1	1	0	0
6bb98682716	01	3	1	2	1	0	0
6ed5ef5fe02	01	98	89	9	8	1	0
c8bbd13ea8d	00	1598	951	647	222	2	2
d8b33dc1478	22	2	1	1	1	0	0
37fd953378e	22	55	26	29	4	0	0
079b81358bf	22	2	1	1	1	0	0
d4ed2e61f7a	15	7	7	0	1	0	0
45c1d4f96f4	21	24	23	1	2	0	0
10ce3d129d4	23	68	67	1	3	0	0
963459d736d	23	882	879	3	11	5	0
a26bee8fa16	23	131	93	38	15	0	0
db45b2ca02d	05	8	1	7	1	0	0
e1dd5705857	05	8	1	7	1	0	0
35c0cd219d0	05	29	9	20	1	0	0
91701c2db10	07	11	1	10	1	0	0
88f94fa28c4	04	8	6	2	1	0	0
ac1aaddc001	23	38	22	16	2	0	0
7407be896ef	23	43	36	7	2	0	0
80a55e9c835	02	17	6	11	1	0	0
0c0f13eda46	23	10	8	2	1	0	0
93cefab1a3a	23	5	4	1	1	0	0
04271a5e939	01	6	3	3	1	0	0
e0660740d9e	01	94	94	0	3	3	0
3ba9519fafb	01	2	1	1	0	0	0
8b82abb9532	01	94	94	0	3	3	0
d0365fd21f0	01	2	1	1	0	0	0
e8067cb6856	17	4	2	2	1	0	0
f160a45b254	23	29	26	3	2	0	0
c75f71dd721	15	59	56	3	2	1	0
06ada03ed93	15	59	56	3	2	1	0
93eca95aece	05	1	0	1	1	0	0
45b772d8cb3	23	3	3	0	1	0	0
08e2e570a7d	23	37	36	1	2	2	0
57d722011aa	23	10	8	2	1	0	0
e81a5e9c9cd	23	7	0	7	0	0	0
37ac5e52bfa	21	4824	2038	2786	256	19	9
b9bfb1bc916	21	3	2	1	1	0	0
01d46f3a204	04	185	155	30	3	0	0
1e577f347b0	01	11	1	10	4	0	0
2726c22f0b8	00	2	0	2	1	0	0
90ce5b3d41a	19	64	32	32	6	0	0
8d3278b9620	18	4	2	2	1	0	0
5cda2542fdb	23	53	51	2	1	0	0
9a70d99980c	03	200	100	100	98	0	0
7abbda8ba2e	23	38	37	1	2	2	0
6ebe9e0c1d2	17	59	38	21	2	0	0
6aa755070a5	15	4	2	2	1	0	0
af90faf198f	02	3	1	2	1	0	0
4b64542fe09	02	8257	6020	2237	195	14	0
8a15147bc53	02	29	25	4	1	0	0
cda3b6ff52e	02	5286	2195	3091	167	20	14
066789a6e33	08	7	7	0	0	0	0
a7dce478543	18	4	2	2	1	0	0
e513ffef754	00	32	30	2	1	0	0
d497bf845b9	15	24	12	12	5	0	0
76f31faa3b8	15	29	16	13	5	0	0
d2270843393	23	25	21	4	5	0	0
a7cd76bb3b3	23	285	0	285	5	0	5
67f1778065b	23	781	504	277	123	2	0
d2389f8fab2	02	43	26	17	2	0	0
c781f177421	02	29	25	4	1	0	0
81cd3a3cd62	02	4	2	2	1	0	0
dce86828273	20	51	26	25	2	0	0
89653cb32fa	16	211	109	102	100	0	0
815169383ee	18	2	1	1	1	0	0
7bee98bae25	18	3	3	0	1	0	0
851b3970e72	18	2	1	1	1	0	0
d980620010a	18	3	3	0	1	0	0
76a771b749c	15	24	12	12	5	0	0
46376888cd2	15	29	16	13	5	0	0
0fb4fb4797e	00	8	8	0	1	0	0
702b46c80df	21	2	0	2	1	0	0
b9bd2d3eb9a	17	4	2	2	1	0	0
9f7f86b534f	00	54	39	15	6	0	0
06bf0707f7d	15	2	1	1	0	0	0
571a51989e2	15	20	12	8	3	0	0
f631c1d73b8	23	27907	27564	343	213	100	3
ad5a108dfd5	23	591	445	146	21	1	0
bda08bfa044	21	4	2	2	1	0	0
f06abda6f58	16	82	68	14	5	0	0
10dc129a4b7	17	222	122	100	101	2	0
8b79a31333d	16	2	2	0	1	0	0
943c396b861	16	3	0	3	1	0	0
4e85257c6ea	04	3	1	2	1	0	0
e4fc2cbfd35	04	16019	11157	4862	189	18	0
bcb0cc0b184	04	27552	27246	306	202	98	3
a10cfba766e	17	67	66	1	2	0	0
150053b3fa6	03	2	1	1	1	0	0
fb53986a801	02	10	10	0	1	1	0
17da4242b0d	02	13	13	0	1	1	0
d5fca08da45	02	81	81	0	1	1	0
33f9074a621	18	87	86	1	3	1	0
8258bd467a1	18	3	1	2	1	0	0
959a19e1184	07	8	5	3	2	0	0
5ca5ec33cca	06	11	6	5	1	0	0
f1742c93d7f	06	1	0	1	1	0	0
a42b4ad44e6	06	6	3	3	1	0	0
1d59a73fefb	01	2	2	0	1	0	0
cf6e4d82e76	01	28	14	14	5	0	0
2e487379ada	00	38	36	2	1	0	0
f70be203e4a	00	20	10	10	1	0	0
c368e46e7fe	23	9	9	0	1	0	0
3dfa98c9917	23	6	5	1	1	0	0
2d44dcc8be9	23	64	52	12	26	0	0
4053c01b53f	22	4	2	2	1	0	0
2f256af4124	21	4	2	2	1	0	0
48a2d34cfe6	18	68	54	14	5	0	0
ef5b0f4c8eb	20	7	5	2	1	0	0
2d6a076ab32	23	10	8	2	1	0	0
c0c4e008aa0	19	160	75	85	9	0	0
1bf3a143539	17	208	105	103	100	0	0
054127112ce	17	1556	1182	374	218	4	1
d8c5ba21854	04	47	46	1	2	1	1
4ca3fd0a01d	19	6	6	0	1	0	0
86d077da006	19	2	1	1	1	0	0
17db291b5cc	19	4	3	1	2	0	0
7bfa5cf284d	19	380	191	189	8	1	1
674416fbc9b	19	1305	652	653	7	1	1
b34feeeb868	19	58	33	25	1	0	0
169b0820f0e	19	18	12	6	1	0	0
3c195d04f30	19	22	11	11	1	0	0
c417de409dd	19	8	4	4	1	0	0
c2f6405a0f4	19	10	5	5	1	0	0
c0446edcc2e	19	22	15	7	1	0	0
4ed05da2bec	19	13	8	5	1	0	0
8d1e5d3ae11	19	4	3	1	1	0	0
774c289ba85	19	6	5	1	1	0	0
8e22004cb54	19	24	14	10	1	0	0
d39297251f0	19	8	5	3	1	0	0
3b6c1d74c7f	19	11	7	4	1	0	0
798f8a0dc10	19	12	7	5	1	0	0
e083720d548	19	67	33	34	1	0	0
3ce782b7f2b	19	16	8	8	1	0	0
8a121fa0e7b	19	26	14	12	1	0	0
e8ad5b9c1ca	19	119	51	68	1	0	0
e88a1ba74a6	19	105	93	12	1	0	0
c205d3b53a1	19	6	3	3	1	0	0
4f24b20fcbf	19	35	18	17	1	0	0
a62ec4437ba	19	72	57	15	1	0	0
2a6ff3f56b3	19	189	96	93	1	0	0
14d4fbb0029	19	25	13	12	1	0	0
cacb28c92cc	19	22	11	11	1	0	0
db8c55e77c8	19	93	63	30	1	0	0
f775c5cea4f	19	22	11	11	1	0	0
032b877f31d	19	71	56	15	1	0	0
6738d82e38e	19	12	6	6	1	0	0
03d6aa07ea8	19	228	177	51	1	0	0
d383954ffe0	19	24	12	12	1	0	0
5d4e3d2d0cb	19	2	1	1	1	0	0
df5be65415c	19	18	9	9	1	0	0
d71f9944cc5	19	63	61	2	3	1	0
f28d482cd43	19	661	381	280	5	1	1
5824881e4a8	19	6	0	6	3	0	1
1a181315eba	19	11	6	5	1	0	0
63629614cbf	19	48	24	24	1	0	0
8cd13eb74e3	18	32	20	12	1	0	0
ffcdcc7ff06	18	1610	8	1602	2	0	2
4051c2843b1	22	1251	616	635	89	38	44
217bb47b027	18	1892	1892	0	12	15	0
44daa9836b5	01	36	29	7	1	0	0
29463cb60c2	00	15	11	4	1	0	0
692bcbe559b	23	59	22	37	1	0	0
50cfeef65e6	21	2	1	1	1	0	0
412cebec9e0	23	1	0	1	1	0	0
2e24ded6d23	21	7072	6248	824	79	1	1
4f8d7328a46	21	2	1	1	0	0	0
fde26002f17	23	1	0	1	1	0	0
f4641bd4de5	00	10239	7434	2805	175	11	0
7af2d6b9851	19	6	6	0	1	0	0
909ea3008ef	19	2	1	1	1	0	0
5571c1aaa4e	19	4	3	1	2	0	0
f9df88c6dae	19	380	191	189	8	1	1
f9e464f95a7	19	1304	652	652	7	1	1
9fe92590b24	19	58	33	25	1	0	0
f4720d8dbd7	19	18	12	6	1	0	0
8e6086b4033	19	22	11	11	1	0	0
a54b70a355e	19	8	4	4	1	0	0
cf4700aff42	19	10	5	5	1	0	0
c9b35b99233	19	26	17	9	1	0	0
c4d6c7f8296	19	13	8	5	1	0	0
f0694e1e0c9	19	4	3	1	1	0	0
03968739c5c	19	6	5	1	1	0	0
94c6bcfdad5	19	24	14	10	1	0	0
dfdf09d43d0	19	8	5	3	1	0	0
728386bfb21	19	11	7	4	1	0	0
628bc835ae3	19	12	7	5	1	0	0
a52254d0d78	19	65	35	30	1	0	0
aef61ee3671	19	16	8	8	1	0	0
0e752246d38	19	26	14	12	1	0	0
2fd5cb3d2e0	19	102	49	53	1	0	0
0cf7156f085	19	105	93	12	1	0	0
2806c6ce28c	19	6	3	3	1	0	0
02e288b640b	19	35	18	17	1	0	0
af7314e190e	19	69	54	15	1	0	0
40190b7c92d	19	197	100	97	1	0	0
ec02e827602	19	25	13	12	1	0	0
2f148845e8a	19	22	11	11	1	0	0
9a0495a4b0f	19	93	63	30	1	0	0
dd1b3b6dfd3	19	22	11	11	1	0	0
ab294ad93df	19	73	57	16	1	0	0
6e51db12689	19	180	123	57	1	0	0
60aa852a036	19	228	177	51	1	0	0
97ee38707bc	19	24	12	12	1	0	0
44559a32119	19	2	1	1	1	0	0
24a2706a3bb	19	18	9	9	1	0	0
11d27367cdc	19	63	61	2	3	1	0
bd880e7f3fc	19	705	403	302	5	1	1
3bec62b0125	19	6	0	6	3	0	1
3d5f7594b58	19	11	6	5	1	0	0
ac5e7072c97	19	48	24	24	1	0	0
7aee49d9677	18	34	20	14	1	0	0
7d6d5e263e8	18	1610	8	1602	2	0	2
964d03bc3f0	18	1892	1892	0	12	15	0
ca0986fbd1a	02	2363	1858	505	132	7	0
d4d45a17578	02	2363	1858	505	132	7	0
59ecf2ccf74	22	21	18	3	1	0	0
f492baa61dd	22	4	2	2	1	0	0
d384b8b0d2a	00	70	53	17	6	0	0
a9130222bd3	22	21	3	18	1	0	0
1b5048b2886	08	12	8	4	1	0	0
d3b83726157	01	2	1	1	1	0	0
73806b56e56	00	6	6	0	0	0	0
9a6f936c8a6	04	8	8	0	1	0	0
92cb684e784	04	47	46	1	2	1	1
e004721b482	19	13	12	1	0	0	0
634b4de2c83	23	35	35	0	2	1	0
27d8b059fa2	23	35	35	0	2	1	0
186960fefb5	20	1	1	0	0	0	0
3817b12fec5	20	1	1	0	0	0	0
bae4018b301	20	2	1	1	0	0	0
96338432e2b	00	1	1	0	0	0	0
0cdf85e28d5	23	1291	749	542	61	0	0
f73f07e1266	21	4	2	2	1	0	0
1eb1fe32250	00	79	62	17	6	0	0
a2851b62345	18	216	6	210	3	0	2
4672872ddde	18	4	2	2	0	0	0
7a1a62ec6e1	22	99	53	46	5	0	0
6a2cb6c506f	19	4	2	2	1	0	0
de21de920cf	22	62	44	18	6	0	0
0a4f5e84734	22	6	6	0	1	1	0
f5ab8a7141d	23	53	37	16	5	0	0
9a0d90793ef	23	4	3	1	1	0	0
df236e75a2f	08	2	1	1	1	0	0
a7af84f988a	22	1251	616	635	89	38	44
3a915b02e8a	19	92	48	44	4	0	0
5041bc1b6cc	18	4	1	3	1	0	0
68a0c56a7d9	18	6165	3882	2283	110	6	0
e9adb7fbbc4	04	3	3	0	1	0	0
830d0fe95a9	03	2	1	1	1	0	0
163900dc68e	20	911	482	429	204	1	1
02c1cb54aa2	17	3	2	1	0	0	0
e612143a896	00	4	2	2	1	0	0
99059aad8d6	23	49	32	17	6	0	0
349cab0b489	23	9	9	0	0	0	0
986785c9d29	07	16	0	16	1	0	0
e5db01ee29e	23	1	0	1	1	0	0
8be699494ec	23	6148	4439	1709	128	5	0
74a2528bd71	01	4	2	2	1	0	0
051908e023f	00	57	40	17	6	0	0
5937d02aed6	00	3	2	1	1	0	0
71527e3a55b	23	10	8	2	1	0	0
465f57c56f9	23	14	11	3	2	0	0
30fd2f7bb27	22	3	3	0	1	0	0
ec79acb3a61	21	4	2	2	1	0	0
a3efcd20066	02	63	45	18	6	0	0
05471f5c2ae	02	3405	2223	1182	90	0	0
ca4b91a1d00	01	2	1	1	0	0	0
5756d7916a1	00	4	2	2	1	0	0
f19e20d33f5	21	55	38	17	6	0	0
38651521a86	21	2	1	1	1	0	0
f98999cc166	21	57	52	5	3	0	0
ff0f0aeb401	01	104	100	4	3	2	0
5c0f039c9ca	20	194	97	97	95	0	0
77f2cb66d1b	01	4	2	2	1	0	0
a74354735ab	23	45	32	13	4	0	0
40879f33cd0	00	6206	2242	3964	139	3	20
b1b16d117e6	23	8	4	4	1	0	0
f33a35e293f	21	10	5	5	5	0	0
7b93eb0000a	21	1	1	0	1	0	0
6768d2fc936	10	489	317	172	9	1	0
5c0d11b12a8	10	24	17	7	0	0	0
5d7577c71ab	10	18	14	4	1	0	0
4fd315192a2	22	0	0	0	13	13	0
f25ec0782e3	05	2	2	0	0	0	0
ec1d1ee61fa	05	4	2	2	1	0	0
d18cebaf8a7	01	52	40	12	4	0	0
4afc46d7bcb	02	1420	586	834	27	1	0
25410096b4c	23	2644	1835	809	139	3	3
8cca30f31b2	20	37	17	20	1	0	0
ff4096f958f	01	4	2	2	1	0	0
d5a189acef1	23	73	61	12	4	0	0
d84a6ba3d13	00	4	2	2	0	0	0
78dbb4b5b1b	23	1179	844	335	203	4	0
