Commit ID 	 Time 	 LOCChanged 	 LOCADD 	 LOCRem 	 Totalfiles 	 Filesadd 	 Filesrem 
3e667804ebc	18	1	1	0	1	0	0
f013f15c891	11	8	4	4	1	0	0
2fe780b36c3	19	19	18	1	0	0	0
01432403afc	16	28	28	0	2	1	0
7161ecd31ba	09	2	1	1	1	0	0
943448772e9	19	48	43	5	2	0	0
e2126e05e7a	16	29	6	23	3	0	0
82bcdbb8aaa	10	2	2	0	1	0	0
1fc2c3823ce	10	4	2	2	2	0	0
66e12dbd696	16	3	2	1	1	0	0
f079c0bd9f3	22	48	32	16	1	0	0
