Commit ID 	 Time 	 LOCChanged 	 LOCADD 	 LOCRem 	 Totalfiles 	 Filesadd 	 Filesrem 
ea290e727de	14	31	20	11	5	0	0
ad15067ea01	14	37	37	0	2	1	0
c192a1b5df9	14	4	1	3	1	0	0
6550e8cfa07	14	6	5	1	1	0	0
ce85f84d152	06	41	30	11	3	0	0
79010540fcc	06	23	23	0	1	1	0
6b9e5eedf2f	06	18	18	0	1	1	0
d04ef897580	10	6	6	0	1	0	0
565becb8ad6	10	1624	905	719	2	0	0
9e6603476aa	08	26	19	7	1	0	0
