Commit Id	Time	Total LOC	LOC added	LOC removed	Files affected	Files added	Files removed	Commit Msg
6e1eac744b0	9	20	15	5	2	0	0	11
d2f2a32b897	22	14	8	6	1	0	0	7
42b93437102	23	38	18	20	8	0	0	23
a0a180a0adb	23	8	1	7	1	0	0	10
35b9580cd84	22	150	149	1	5	0	0	18
28eee0adb78	9	2	1	1	1	0	0	8
ce112c27c63	22	1071	921	150	30	2	0	12
a5f1307e453	7	10	5	5	1	0	0	12
e46cbaa06d6	7	2	1	1	1	0	0	31
9d9ed61c5a9	14	491	269	222	24	1	0	9
69904c8a783	21	68	45	23	10	0	0	9
0308ad2ce53	21	2	1	1	1	0	0	135
1c031c84d25	20	205	172	33	16	0	0	9
20a7088d9c6	20	477	356	121	50	0	0	9
