Commit Id	Time	Total LOC	LOC added	LOC removed	Files affected	Files added	Files removed	Commit Msg
42a33c1bb86	12	21	19	2	2	0	0	90
ec57ecc982d	7	158	129	29	2	1	0	47
5b230007adb	5	26	6	20	1	0	0	49
028e652a733	20	9	8	1	1	0	0	43
60a1dbddd2a	22	70	67	3	3	1	0	72
bf0bc3565b2	19	7	4	3	1	0	0	55
8ac1a736353	19	2	1	1	1	0	0	52
e85927119cd	9	9	8	1	2	0	0	51
ab518ae50e4	18	9	7	2	1	0	0	77
06a058d731f	22	142	100	42	3	0	0	71
415bff26fe5	1	14	14	0	2	0	0	78
